..........
..GXEXXX..
.XGGGXXGG.
.XXEGXEGX.
.XXXSSGGE.
.EGGSSXXX.
.XGEXGEXX.
.GGXXGGGX.
..XXXEXG..
..........
